            SO files/b     
            WE files/b       
        EA files/c      
        NO files/d    


F 200,01,28
C 225,30,22

        1111111111111111111111111
        1000000000110000000000001
        1011000001110000000000001
        1001000000000000000000001
111111111011000001110000000000001
100000000011000001110111111111111
11110000000001011100000010001
11110111111111011101010010001
11000000110101011100000010001
10000000000000001100000010001
1000000000000000110101000000111
110000011101010111110111100S01
11110111 1110101 10000001000111
11111111 1111111 111111111111