NO textures/simonkraft/respawn_anchor_side0.xpm
EA textures/simonkraft/respawn_anchor_side2.xpm
SO textures/simonkraft/respawn_anchor_side4.xpm
WE textures/simonkraft/respawn_anchor_side3.xpm

C 35,19,73
F 15,6,40

111111111111111111111111
100000000D00000000000001
101111111100001111000001
100000000001111000111101
100011110000100000000001
100010000001000111111101
100011111111000000000001
100000000000111110000101
101111100000000001111101
100000111111000000000001
100000100000111111000101
100000111111000000000001
101111100000111110111101
100000000000100000000001
100011111111111111111101
100010000000N00000000001
100011111110000111100001
100000000001111100000001
101111111110000000000001
111111111111111111111111
