            SO ./textures/minimap/Castle/Castle_Floor_Big.xpm
            WE ./textures/minimap/Castle/Castle_Floor_Big.xpm       
        EA ./textures/minimap/Castle/Castle_Floor_Big.xpm      
        NO ./textures/minimap/Castle/Castle_Floor_Big.xpm    


F 200,01,28
C 225,30,22

        1111111111111111111111111
        1000000000110000000000001
        10110W001110000000000001
        1001000000000000000000001
111111111011000001110000000000001
100000000011000001110111111111111
11110000000001011100000010001
11110111111111011101010010001
11000000110101011100000010001
10000000000000001100000010001
1000000000000000110101000000111
11000001110101011111011110001
11110111 1110101 10000001000111
11111111 1111111 111111111111
